#######
#     #
# ### #
# #E  #
# ### #
#S  # #
#######
