#######
#E    #
### ###
# # # #
# # # #
#S    #
#######
